######
#   =#
# ####
# ####
#\.###
#.####
#%...#
######
