#####
#=..#
#.\.#
#.#.#
#.%.#
#####
